{
  "id": "crossroad",
  "tiles": [
    "###############################",
    "#############.....#############",
    "#############.....#############",
    "#############.....#############",
    "#############..S..#############",
    "#############.....#############",
    "#############.....#############",
    "#.............................#",
    "#.............................#",
    "#.............S...............#",
    "EP............................L",
    "#.............S...............#",
    "#.............................#",
    "#.............................#",
    "#############.....#############",
    "#############.....#############",
    "#############..S..#############",
    "#############.....#############",
    "#############.....#############",
    "#############.....#############",
    "###############################"
  ]
}