{
  "id": "chambers",
  "tiles": [
    "#########################",
    "#.........#.............#",
    "#.........#.............#",
    "#....S....#.....S.......#",
    "#.........#.............#",
    "#####..#######..#########",
    "#.......................#",
    "EP......................L",
    "#.......................#",
    "#########..#######..#####",
    "#.........#.............#",
    "#....S....#.....S.......#",
    "#.........#.............#",
    "#.........#.............#",
    "#########################"
  ]
}