{
  "id": "ring",
  "tiles": [
    "###################################",
    "#.................................#",
    "#.................................#",
    "#....S.......................S....#",
    "#.................................#",
    "#......#########...#########......#",
    "#......#...................#......#",
    "#......#...................#......#",
    "#......#...................#......#",
    "#......#...................#......#",
    "EP.....#.........S.........#......L",
    "#......#...................#......#",
    "#......#...................#......#",
    "#......#...................#......#",
    "#......#...................#......#",
    "#......#########...#########......#",
    "#.................................#",
    "#....S.......................S....#",
    "#.................................#",
    "#.................................#",
    "#.................................#",
    "#.................................#",
    "###################################"
  ]
}