{
  "id": "corridor",
  "tiles": [
    "#####################",
    "#...................#",
    "#...................#",
    "#....S.......S......#",
    "EP..................L",
    "#....S.......S......#",
    "#...................#",
    "#...................#",
    "#####################"
  ]
}