{
  "id": "boss_chamber",
  "tiles": [
    "####################L####################",
    "#.......................................#",
    "#.......................................#",
    "#.......................................#",
    "#.......................................#",
    "#.......................................#",
    "#.......................................#",
    "#.......................................#",
    "#...................S...................#",
    "#.......................................#",
    "#.......................................#",
    "#.......................................#",
    "#.......................................#",
    "#.......................................#",
    "#.......................................#",
    "#.......................................#",
    "#.......................................#",
    "#.......................................#",
    "#.......................................#",
    "#.......................................#",
    "#.......................................#",
    "#.......................................#",
    "#.......................................#",
    "#.......................................#",
    "#.......................................#",
    "#.......................................#",
    "#.......................................#",
    "#...................P...................#",
    "####################E####################"
  ]
}